{
    "metadata": {
        "version": 1.0,
        "encoding": "Elder Futhark"
    },
    "mappings": {
        "standard": {
            "a": "\u16AB",
            "b": "\u16D2",
            "c": "\u16B2",
            "d": "\u16DE",
            "e": "\u16D6",
            "f": "\u16D3",
            "g": "\u16B7",
            "h": "\u16BA",
            "i": "\u16C1",
            "j": "\u16C3",
            "k": "\u16B2",
            "l": "\u16DA",
            "m": "\u16D7",
            "n": "\u16BE",
            "o": "\u16DF",
            "p": "\u16C8",
            "q": "\u16B2",
            "r": "\u16B1",
            "s": "\u16CB",
            "t": "\u16CF",
            "u": "\u16A2",
            "v": "\u16A2",
            "w": "\u16B9",
            "x": "\u16A4",
            "y": "\u16C3",
            "z": "\u16C9",
            ".": "\u16EC",
            ",": "\u16EC",
            "space": "\u16EB"
        },
        "shifted": {
            "T": "\u16A6",
            "N": "\u16DC",
            "I": "\u16C1",
            "A": "\u16AB",
            "B": "\u16D2",
            "C": "\u16B2",
            "D": "\u16DE",
            "E": "\u16D6",
            "F": "\u16D3",
            "G": "\u16B7",
            "H": "\u16BA",
            "J": "\u16C3",
            "K": "\u16B2",
            "L": "\u16DA",
            "M": "\u16D7",
            "O": "\u16DF",
            "P": "\u16C8",
            "Q": "\u16B2",
            "R": "\u16B1",
            "S": "\u16CB",
            "U": "\u16A2",
            "V": "\u16A2",
            "W": "\u16B9",
            "X": "\u16A4",
            "Y": "\u16C3",
            "Z": "\u16C9",
            ">": "\u16EC",
            "space": "\u16EB",
            "?": "\u16EC",
            "!": "\u16EC"
        }

    }
}